width=10
height=10
entrance=9,6
exit=6,3
key=SECRET@3,7
#maze
!0000000000
!0001111000
!0001001000
!0000111111
!0000100000
!0000100000
!0000111000
!0000000000
!0000000000
!0000000000
