width=8
height=8
entrance=3,7
exit=2,0
#maze
!00010000
!01111110
!01111110
!01110110
!01111110
!01011110
!01111110
!00100000