width=9
height=9
entrance=4,4
exit=4,0
#maze
!111111111
!111111111
!111111111
!111010111
!111010111
!111000111
!111111111
!111111111
!111111111