width=33
height=32
entrance=1,31
exit=31,0
key=UBER@17,19
#maze
!010000000000000000000000000000000
!011101111101111101110111010111110
!000101000100000101010100010000010
!011101011111110111011111011101110
!010001000101000100000100000100010
!010111011101011111010111110111010
!011111011101110101110111111101110
!010000010000000101010000000101010
!011111110111111111011111111101010
!000001000100000100010000000100000
!011111010111011101111111010101010
!010001010001000000000001010001010
!010111011101011101010111010111110
!000000010001010101010001010100010
!011111110101110101111111011101010
!000100010101000001000000010001010
!011111011111011111010111010101110
!010001000000000100010100010101000
!011101011101011111110111010101010
!000100000101000000000001010101010
!011111110111011101011111010111110
!010000010100000101010100000100010
!011111010101111101110101110101110
!010000000101000001010101110101110
!011101110111110111010101111111010
!010001010000010100000101010000010
!011101010111110111110111011111110
!000101010101000001010000000000000
!011101011101011101011101111111110
!010001010000010100010101010000000
!011111011111110111110111011111110
!000000000000000000000000000000010