width=24
height=20
entrance=1,19
exit=3,0
key=TRIAL@17,9
#maze
!010000000000000000000000
!011101111101111101110110
!000101000100000101010100
!011101011111110111011110
!010001000101000100000100
!010111011101011111010110
!011111011101110101110110
!010000010000000101010000
!011111110111111111011110
!000001000100000100010000
!011111010111011101111110
!010001010001000000000000
!010111011101011101111110
!000000010001010101010000
!011111110101110101111110
!000100010101000101000000
!011111011111011111011110
!010001000000000100010100
!011101011111111111110110
!000100000000000000000000