width=13
height=10
entrance=0,6
exit=2,6
key=BACKTRACK@4,6
#maze
!0000000000000
!0000000000000
!0000000000000
!1111111110000
!0010000010000
!0010000010000
!0010000010000
!0011111110000
!0000000000000
!0000000000000