width=13
height=9
entrance=9,4
exit=0,4
#maze
!0000000000000
!0111111111110
!0101110111010
!0101010101010
!1111011101110
!0101010101010
!0101110111010
!0111111111110
!0000000000000