width=10
height=10
entrance=0,7
exit=7,6
#maze
!0000000000
!0111111110
!1101110110
!0101110110
!0101010110
!0111011110
!0101010110
!0101110110
!0101110110
!0000000000