width=10
height=10
entrance=1,0
exit=9,8
#maze
!0000000000
!0111111111
!0100000000
!0100000000
!0101111100
!0101000100
!0111011100
!0000010000
!0111110000
!0100000000
