width=13
height=10
entrance=6,0
exit=6,1
key=BACKTRACK@9,6
#maze
!0000000000000
!0000000000000
!0000000000000
!0101010101010
!0101010101010
!0111011101110
!0010001000100
!0011111111100
!0000001000000
!0000001000000