width=24
height=24
entrance=11,23
exit=10,0
#maze
!000000000001000000000000
!000000000001000000000000
!000000111111111111000000
!000000100000000001000000
!000000100000000001000000
!000011111000000011110000
!000010001000000010010000
!000010000000000010000000
!000010000000000010000000
!011110000000011110000000
!010010000000010010000000
!010010000000010010000000
!000010000000000010000000
!000010000000000010000000
!000011111111111110000000
!000000000010000000000000
!000000000010000000000000
!000000000010000000000000
!000000000011110000000000
!000000000010010000000000
!000000000010010000000000
!000000000010000000000000
!000000000010000000000000
!000000000010000000000000