width=16
height=16
entrance=0,7
exit=15,8
key=SECRET@3,0
#maze
!0000000000000000
!0000000000000000
!0001111000000000
!0001000000000000
!0111000000000000
!0101111000000000
!0100000000000000
!0100000001111111
!1101111111000000
!0111000001110000
!0101111100000000
!0100000000000000
!0100000000000000
!0101111110000000
!0111000000000000
!0001111111000000