width=8
height=8
entrance=1,7
exit=3,0
#maze
!01000000
!01111100
!01010100
!01111100
!01010100
!01111100
!00010000
!00010000