width=8
height=8
entrance=2,7
exit=7,3
#maze
!00100000
!00100000
!00100000
!01111000
!01111111
!01111000
!00000000
!00000000