width=8
height=8
entrance=7,3
exit=0,3
#maze
!00000000
!00000000
!00000000
!00111100
!11100111
!00111100
!00000000
!00000000